000000000000000000000000000000000000000000000000000000000000000000000000000000000000000000000000000000000000000000000000000000000000000000000000000001
000000000000000000000000000000000000000000000000000000000000000000000000000000000000000000000000000000000000000000000000000000000000000000000000000001
000000000000000000000000000000000000000000000000000000000000000000000000000000000000000000000000000000000000000000000000000000000000000000000000000001
000000000000000000000000000000000000000000000000000000000000000000000000000000000000000000000000000000000000000000000000000000000000000000000000000001
000000000000000000000000000000000000000000000000000000000000000000000000000000000000000000000000000000000000000000000000000000000000000000000000000001
000000000000000000000000000000000000000000000000000000000000000000000000000000000000000000000000000000000000000000000000000000000000000000000000000001
000000000000000000000000000000000000000000000000000000000000000000000000000000000000000000000000000000000000000000000000000000000000000000000000000001
000000000000000000000000000000000000000000000000000000000000000000000000000000000000000000000000000000000000000000000000000000000000000000000000000001
000000000000000000000000000000000000000000000000000000000000000000000000000000000000000000000000000000000000000000000000000000000000000000000000000001
000000000000000000000000000000000022200000000000000000000000000000000000000000000000000000000000000000000000000000000000000000000000000000000000000001
000000000000000000000111111111111111111111111111000000000000000000000000000000000000000000000000000000011111111111100000000000111111100000000000000000
004440000000000000000111111111111111111111111111000000000000000000000000000000000000000000000000000000011111111111100000000000111111100000000000000000
004440000000000000000111111111111111111111111111000000000000000000000000000000000000000000000000000000011111111111100000000000011111000000000000000000
004440000000000000000111111111111111111111111111000000000000000002000000000000000000000000000000000000011111111111100000000000001110000000000055550000
111111111111111111111111111111111111111111111111111111100000001111111000000011111111111110000000111111111111111111111111110000000100000011111111111111
111111111111111111111111111111111111111111111111111111100000001111111000000011111111111110000000111111111111111111111111110000000000000011111111111111
111111111111111111111111111111111111111111111111111111100333001111111003330011111111111110033300111111111111111111111111110000000000000011111111111111
111111111111111111111111111111111111111111111111111111111111111111111111111111111111111111111111111111111111111111111111110000000000000011111111111111
111111111111111111111111111111111111111111111111111111111111111111111111111111111111111111111111111111111111111111111111110000000000000011111111111111